11111111111111111
10110001010000011
10101110011110001
11001010101110001
11111101101010011
10001011000011111
10101000010111001
11000111101101001
10101000011111011
11100011010100001
11110101001001011
11010100110001001
10011101101011001
10101010100100111
11001100011101101
10011101001100001
11111111111111111