11111111111111111
10100011000111111
11000110111001111
10110000111100111
11101111011011001
11101001011111101
10011011101001101
10111100010111101
10011011011111101
11100011011001011
10011111000111011
10100111110111101
11111111111111111